,Ball_Striking_RANK THIS WEEK,Ball_Striking_RANK LAST WEEK,Ball_Striking_PLAYER NAME,Ball_Striking_ROUNDS,Ball_Striking_VALUE,Ball_Striking_TOTAL DRV RANK,Ball_Striking_GIR RANK
0,1,1,Gary Woodland,63,14,3,11
1,T2,T4,Charles Howell III,64,18,13,5
2,T2,T2,Tiger Woods,31,18,17,1
3,4,T4,Paul Casey,51,20,1,19
4,T5,7,Corey Conners,62,21,15,6
5,T5,T2,Brooks Koepka,49,21,11,10
6,7,T4,Matt Kuchar,65,22,19,3
7,8,T8,Emiliano Grillo,65,26,6,20
8,9,T8,Keegan Bradley,65,28,6,22
9,10,T10,Alex Prugh,54,34,19,15
10,T11,18,Rory McIlroy,50,39,30,9
11,T11,T10,Scott Piercy,70,39,31,8
12,13,12,Brendan Steele,50,41,2,39
13,14,T13,Hideki Matsuyama,59,42,16,26
14,15,17,Justin Thomas,49,43,39,4
15,16,15,Aaron Wise,52,48,23,25
16,17,16,Troy Merritt,42,49,19,30
17,T18,20,Jason Kokrak,68,51,10,41
18,T18,T23,Xander Schauffele,55,51,28,23
19,20,T21,Lucas Glover,62,54,26,28
20,21,T23,Jon Rahm,51,55,9,46
21,22,19,Ian Poulter,49,58,34,24
22,23,T21,James Hahn,34,60,58,2
23,24,25,Keith Mitchell,64,63,28,35
24,25,26,Jason Day,45,65,25,40
25,26,27,Kevin Streelman,63,69,27,42
26,27,35,Hank Lebioda,55,71,33,38
27,28,29,Jhonattan Vegas,60,78,50,28
28,29,T33,Rickie Fowler,54,86,23,63
29,T30,T33,Tommy Fleetwood,43,88,18,70
30,T30,T31,Chez Reavie,67,88,42,46
31,32,T39,Patrick Cantlay,49,90,53,37
32,33,30,Russell Knox,65,91,64,27
33,34,36,Adam Scott,41,93,37,56
34,35,T39,Sungjae Im,88,96,32,64
35,36,T31,Carlos Ortiz,60,97,36,61
36,T37,T49,Henrik Stenson,46,98,48,50
37,T37,T13,D.J. Trahan,33,98,84,14
38,39,47,Nick Watney,67,100,66,34
39,40,T37,Abraham Ancer,69,102,12,90
40,T41,T41,Cameron Champ,58,103,87,16
41,T41,T41,Joel Dahmen,78,103,19,84
42,43,43,Dustin Johnson,47,105,92,13
43,44,44,Jim Furyk,53,106,99,7
44,45,T37,Ryan Palmer,56,107,89,18
45,46,T52,Tyrrell Hatton,46,113,34,79
46,T47,T49,Hunter Mahan,45,115,40,75
47,T47,66,Adam Schenk,80,115,53,62
48,49,48,Bryson DeChambeau,45,117,3,114
49,50,45,Sepp Straka,48,119,53,66
50,51,28,Bubba Watson,47,120,46,74
51,52,51,Brice Garnett,63,122,77,45
52,53,T52,Kramer Hickok,59,123,44,79
53,T54,T52,Matt Every,38,124,52,72
54,T54,T58,Webb Simpson,53,124,59,65
55,56,T55,Adam Hadwin,66,129,44,85
56,57,T55,Russell Henley,56,132,77,55
57,58,57,J.J. Spaun,68,136,93,43
58,59,60,Louis Oosthuizen,43,137,8,129
59,T60,T58,Tyler Duncan,66,144,77,67
60,T60,62,Fabián Gómez,44,144,65,79
61,62,61,Chase Wright,53,146,42,104
62,63,T75,Talor Gooch,37,148,136,12
63,64,T64,Sam Ryder,52,149,61,88
64,T65,T69,Lucas Bjerregaard,37,151,40,111
65,T65,T69,Kyoung-Hoon Lee,72,151,108,43
66,67,T80,Sebastián Muñoz,58,153,67,86
67,68,74,Jason Dufner,56,154,133,21
68,T69,68,Cameron Davis,54,156,84,72
69,T69,T77,Sung Kang,67,156,47,109
70,T71,73,Billy Horschel,73,159,106,53
71,T71,T77,Marc Leishman,52,159,126,33
72,T71,87,Kevin Tway,62,159,110,49
73,T71,67,Johnson Wagner,45,159,142,17
74,75,T95,Martin Laird,60,160,114,46
75,76,T80,Byeong Hun An,54,163,75,88
76,T77,T84,Dylan Frittelli,55,165,97,68
77,T77,83,Ryan Moore,54,165,89,76
78,T77,72,Harold Varner III,62,165,70,95
79,80,T84,Kevin Na,54,166,87,79
80,81,T64,Harris English,72,168,62,106
81,82,88,Matt Jones,67,169,72,97
82,T83,93,Joaquin Niemann,68,173,72,101
83,T83,T77,Wes Roach,45,173,53,120
84,85,T84,Trey Mullinax,67,174,118,56
85,T86,T89,Daniel Berger,48,177,13,164
86,T86,T69,Nate Lashley,44,177,146,31
87,T86,63,Seth Reeves,52,177,67,110
88,T89,T91,Ryan Armour,66,178,100,78
89,T89,T89,Bronson Burgoon,37,178,59,119
90,T89,T95,Andrew Landry,56,178,75,103
91,92,T95,J.B. Holmes,54,179,108,71
92,T93,T91,Luke List,52,180,93,87
93,T93,99,Justin Rose,42,180,62,118
94,T95,106,Austin Cook,50,185,53,132
95,T95,94,Justin Harding,31,185,5,180
96,97,100,Tony Finau,61,188,72,116
97,T98,T75,Alex Noren,49,195,37,158
98,T98,82,Josh Teater,47,195,144,51
99,100,T107,John Chin,38,196,164,32
100,101,T107,Rory Sabbatini,71,200,100,100
101,102,103,Kevin Kisner,65,202,80,122
102,103,104,Kyle Stanley,53,208,82,126
103,104,102,Roger Sloan,62,209,67,142
104,105,109,Adam Long,52,213,80,133
105,106,T113,Ben Silverman,54,216,105,111
106,107,105,Bud Cauley,61,217,104,113
107,T108,T113,Michael Thompson,56,218,83,135
108,T108,T111,Cameron Tringale,52,218,160,58
109,110,T95,Shawn Stefani,57,220,152,68
110,111,101,Jim Knous,55,222,170,52
111,T112,116,John Senden,39,223,187,36
112,T112,115,Danny Willett,47,223,170,53
113,114,T117,Denny McCarthy,63,224,93,131
114,115,T128,Scott Brown,66,228,130,98
115,T116,110,Jim Herman,37,229,50,179
116,T116,122,Beau Hossler,66,229,121,108
117,118,T125,Hudson Swafford,59,231,154,77
118,T119,T117,David Hearn,41,233,110,123
119,T119,120,Phil Mickelson,41,233,131,102
120,121,T111,Sergio Garcia,39,234,93,141
121,122,121,Branden Grace,62,236,144,92
122,123,124,Brandon Harkins,67,238,117,121
123,124,123,Francesco Molinari,41,241,49,192
124,125,T128,Haotong Li,32,243,89,154
125,126,130,Danny Lee,66,247,142,105
126,127,T125,Stewart Cink,33,248,189,59
127,T128,135,Anders Albertson,48,252,156,96
128,T128,131,Rafa Cabrera Bello,57,252,100,152
129,130,138,Graeme McDowell,61,253,138,115
130,131,146,Adam Svensson,51,254,175,79
131,132,137,Andrew Putnam,57,256,196,60
132,T133,133,Wyndham Clark,61,257,98,159
133,T133,134,Brian Stuard,76,257,114,143
134,135,132,Sam Burns,66,258,86,172
135,136,127,Roberto Castro,54,262,168,94
136,137,139,Vaughn Taylor,69,263,124,139
137,138,T142,Sangmoon Bae,42,266,106,160
138,T139,136,Kiradech Aphibarnrat,49,268,70,198
139,T139,151,J.T. Poston,76,268,121,147
140,141,T149,Patrick Rodgers,44,270,134,136
141,142,T147,Chesson Hadley,58,271,128,143
142,T143,T147,Chris Kirk,47,273,182,91
143,T143,T144,C.T. Pan,64,273,150,123
144,145,T142,Roberto Díaz,51,275,124,151
145,146,T140,Peter Uihlein,65,276,177,99
146,147,T154,Max Homa,61,278,140,138
147,T148,T149,Matthew Fitzpatrick,42,281,110,171
148,T148,153,Charley Hoffman,58,281,164,117
149,150,T144,Jonas Blixt,66,283,135,148
150,151,T140,J.J. Henry,42,286,150,136
151,152,T154,Brian Gay,79,288,110,178
152,153,T157,Ernie Els,43,289,197,92
153,T154,T117,Dominic Bozzelli,53,290,162,128
154,T154,T157,Pat Perez,52,290,160,130
155,156,156,Grayson Murray,36,291,114,177
156,157,T164,Jimmy Walker,61,295,146,149
157,158,160,Patrick Reed,53,299,156,143
158,T159,T164,Patton Kizzire,58,300,126,174
159,T159,T167,Cameron Smith,55,300,136,164
160,161,152,Brady Schnell,38,301,132,169
161,162,T167,Si Woo Kim,65,302,146,156
162,T163,169,Brian Harman,67,303,100,203
163,T163,163,Nick Taylor,70,303,180,123
164,165,173,Zach Johnson,50,304,119,185
165,166,161,Ollie Schniederjans,63,305,121,184
166,167,166,Satoshi Kodaira,51,310,119,191
167,168,159,Scott Stallings,63,311,184,127
168,T169,T174,Chris Thompson,34,312,205,107
169,T169,170,Richy Werenski,63,312,159,153
170,171,172,John Huh,35,319,185,134
171,172,162,Kyle Jones,49,321,138,183
172,173,181,Robert Streb,60,322,183,139
173,174,179,Brandt Snedeker,68,324,156,168
174,175,T174,Tom Hoge,70,330,181,149
175,176,171,Sam Saunders,53,331,168,163
176,177,183,Scott Langley,60,334,140,194
177,178,T176,Matt Wallace,31,337,129,208
178,179,T185,Mackenzie Hughes,58,338,172,166
179,180,180,Ben Crane,41,343,176,167
180,T181,178,Whee Kim,57,344,198,146
181,T181,999,Shane Lowry,30,344,155,189
182,183,184,"Ted Potter, Jr.",56,347,186,161
183,184,T176,Joey Garber,44,348,172,176
184,T185,188,Ryan Blaum,67,350,164,186
185,T185,196,Bill Haas,58,350,163,187
186,T185,999,Tyrone Van Aswegen,30,350,194,156
187,188,T185,Martin Kaymer,38,351,152,199
188,189,182,Jordan Spieth,57,352,191,161
189,T190,189,Stephan Jaeger,59,354,179,175
190,T190,T185,Martin Trainer,51,354,149,205
191,T192,190,Aaron Baddeley,51,355,200,155
192,T192,193,Alex Cejka,41,355,167,188
193,194,T191,Julián Etulain,55,368,195,173
194,195,197,José de Jesús Rodríguez,51,373,192,181
195,196,198,Rod Pampling,40,375,178,197
196,197,T191,Jonathan Byrd,43,376,206,170
197,198,195,Seamus Power,58,381,172,209
198,199,T199,Peter Malnati,64,386,204,182
199,200,194,Kelly Kraft,67,387,187,200
200,201,201,Anirban Lahiri,54,392,189,203
201,T202,999,Martin Piller,30,398,208,190
202,T202,T199,Chris Stroud,54,398,202,196
203,T204,T205,Cody Gribble,52,400,193,207
204,T204,202,Curtis Luck,51,400,207,193
205,T204,204,D.A. Points,33,400,199,201
206,207,203,Charl Schwartzel,34,402,201,201
207,208,T205,Michael Kim,51,404,209,195
208,209,207,Freddie Jacobson,37,409,203,206
