,Total_Driving_RANK THIS WEEK,Total_Driving_RANK LAST WEEK,Total_Driving_PLAYER NAME,Total_Driving_EVENTS,Total_Driving_TOTAL,Total_Driving_DISTANCE RANK,Total_Driving_ACCURACY RANK
0,1,1,Paul Casey,15,71,58,13
1,2,2,Brendan Steele,17,74,30,44
2,T3,T3,Bryson DeChambeau,13,75,41,34
3,T3,T3,Gary Woodland,17,75,11,64
4,5,T5,Justin Harding,9,96,91,5
5,T6,T5,Keegan Bradley,18,98,50,48
6,T6,7,Emiliano Grillo,17,98,67,31
7,8,8,Louis Oosthuizen,12,102,70,32
8,9,10,Jon Rahm,14,109,18,91
9,10,12,Jason Kokrak,17,115,26,89
10,11,9,Brooks Koepka,13,117,14,103
11,12,11,Abraham Ancer,20,118,99,19
12,T13,13,Daniel Berger,14,119,61,58
13,T13,T14,Charles Howell III,19,119,43,76
14,15,16,Corey Conners,20,120,81,39
15,16,17,Hideki Matsuyama,15,121,25,96
16,17,T14,Tiger Woods,8,123,63,60
17,18,T20,Tommy Fleetwood,11,128,46,82
18,T19,T20,Joel Dahmen,22,131,116,15
19,T19,18,Matt Kuchar,16,131,121,10
20,T19,19,Troy Merritt,12,131,102,29
21,T19,T22,Alex Prugh,18,131,38,93
22,T23,24,Rickie Fowler,14,132,26,106
23,T23,T22,Aaron Wise,16,132,30,102
24,25,T25,Jason Day,14,135,28,107
25,26,T27,Lucas Glover,17,143,87,56
26,27,T25,Kevin Streelman,20,144,116,28
27,T28,T30,Keith Mitchell,19,145,40,105
28,T28,T36,Xander Schauffele,15,145,28,117
29,30,39,Rory McIlroy,13,146,2,144
30,31,T30,Scott Piercy,19,147,125,22
31,32,T36,Sungjae Im,26,149,96,53
32,33,T44,Hank Lebioda,16,153,102,51
33,T34,40,Tyrrell Hatton,13,154,70,84
34,T34,T30,Ian Poulter,13,154,111,43
35,36,T27,Carlos Ortiz,21,155,54,101
36,T37,T30,Alex Noren,14,157,43,114
37,T37,43,Adam Scott,12,157,48,109
38,39,T48,Justin Thomas,13,158,39,119
39,T40,35,Lucas Bjerregaard,10,160,7,153
40,T40,T41,Hunter Mahan,15,160,99,61
41,T42,T41,Chez Reavie,19,161,159,2
42,T42,T36,Chase Wright,19,161,73,88
43,T44,T44,Adam Hadwin,18,162,125,37
44,T44,T46,Kramer Hickok,19,162,146,16
45,46,29,Bubba Watson,13,163,6,157
46,47,52,Sung Kang,20,165,61,104
47,48,50,Henrik Stenson,12,167,161,6
48,49,53,Francesco Molinari,10,168,119,49
49,T50,T46,Jim Herman,16,170,146,24
50,T50,57,Jhonattan Vegas,18,170,20,150
51,52,T55,Matt Every,12,171,91,80
52,T53,T62,Patrick Cantlay,14,174,15,159
53,T53,60,Austin Cook,17,174,151,23
54,T53,T58,Wes Roach,14,174,119,55
55,T53,T80,Adam Schenk,24,174,58,116
56,T53,67,Sepp Straka,16,174,35,139
57,58,54,James Hahn,10,175,128,47
58,T59,T58,Bronson Burgoon,14,176,125,51
59,T59,T55,Webb Simpson,14,176,156,20
60,61,T62,Sam Ryder,16,177,94,83
61,T62,51,Harris English,21,178,49,129
62,T62,T70,Justin Rose,11,178,22,156
63,64,61,Russell Knox,18,180,135,45
64,65,T65,Fabián Gómez,14,181,148,33
65,66,T83,Nick Watney,20,182,54,128
66,T67,T70,Sebastián Muñoz,18,184,60,124
67,T67,T48,Seth Reeves,18,184,12,172
68,T67,64,Roger Sloan,20,184,76,108
69,T70,T68,Kiradech Aphibarnrat,15,185,111,74
70,T70,T65,Harold Varner III,20,185,37,148
71,T72,T78,Tony Finau,17,186,4,182
72,T72,T76,Matt Jones,19,186,99,87
73,T72,T76,Joaquin Niemann,20,186,56,130
74,T75,82,Byeong Hun An,15,187,21,166
75,T75,T78,Andrew Landry,18,187,179,8
76,T77,T72,Tyler Duncan,22,188,170,18
77,T77,T74,Brice Garnett,21,188,177,11
78,T77,T68,Russell Henley,18,188,171,17
79,T80,T74,Kevin Kisner,17,189,168,21
80,T80,T80,Adam Long,19,189,110,79
81,82,T72,Kyle Stanley,18,190,144,46
82,83,86,Michael Thompson,17,191,179,12
83,T84,T83,Cameron Davis,18,192,16,176
84,T84,34,D.J. Trahan,11,192,45,147
85,86,T87,Sam Burns,22,196,18,178
86,T87,T89,Cameron Champ,19,197,1,196
87,T87,T92,Kevin Na,15,197,122,75
88,T89,T96,Haotong Li,9,199,47,152
89,T89,91,Ryan Moore,16,199,195,4
90,T89,T89,Ryan Palmer,16,199,64,135
91,92,T92,Dustin Johnson,12,200,8,192
92,T93,T83,Sergio Garcia,11,202,34,168
93,T93,T96,Luke List,16,202,3,199
94,T93,T96,Denny McCarthy,20,202,131,71
95,T93,T94,J.J. Spaun,20,202,124,78
96,97,T99,Dylan Frittelli,16,203,86,117
97,98,T99,Wyndham Clark,20,205,5,200
98,99,101,Jim Furyk,16,206,205,1
99,T100,T102,Ryan Armour,21,207,204,3
100,T100,105,Rafa Cabrera Bello,15,207,148,59
101,T100,114,Brian Harman,22,207,171,36
102,T100,106,Rory Sabbatini,19,207,138,69
103,104,T94,Bud Cauley,19,208,113,95
104,105,T102,Ben Silverman,17,209,182,27
105,T106,T108,Sangmoon Bae,16,210,89,121
106,T106,107,Billy Horschel,19,210,133,77
107,T108,T115,J.B. Holmes,18,213,23,190
108,T108,T108,Kyoung-Hoon Lee,22,213,171,42
109,T110,T110,Matthew Fitzpatrick,11,214,174,40
110,T110,112,Brian Gay,22,214,207,7
111,T110,104,David Hearn,14,214,200,14
112,T110,T115,Kevin Tway,19,214,24,190
113,T114,T136,Martin Laird,18,215,83,132
114,T114,113,Grayson Murray,14,215,9,206
115,T114,T115,Brian Stuard,22,215,206,9
116,117,T119,Brandon Harkins,21,216,33,183
117,118,T115,Trey Mullinax,20,217,13,204
118,T119,T143,Zach Johnson,15,218,164,54
119,T119,122,Satoshi Kodaira,16,218,188,30
120,T121,T129,Beau Hossler,20,219,81,138
121,T121,T129,J.T. Poston,22,219,106,113
122,T121,T119,Ollie Schniederjans,22,219,10,209
123,T124,125,Roberto Díaz,16,220,164,56
124,T124,T123,Vaughn Taylor,21,220,195,25
125,T126,T139,Patton Kizzire,18,221,96,125
126,T126,T129,Marc Leishman,14,221,72,149
127,128,T133,Chesson Hadley,20,222,68,154
128,129,T126,Matt Wallace,9,223,36,187
129,130,141,Scott Brown,21,224,154,70
130,131,T126,Phil Mickelson,13,225,17,208
131,132,121,Brady Schnell,14,226,191,35
132,133,T139,Jason Dufner,19,227,164,63
133,134,138,Patrick Rodgers,14,229,50,179
134,135,T133,Jonas Blixt,20,230,145,85
135,T136,T143,Talor Gooch,12,232,74,158
136,T136,T147,Cameron Smith,16,232,77,155
137,T138,T126,Kyle Jones,19,234,193,41
138,T138,152,Graeme McDowell,16,234,161,73
139,T140,T143,Max Homa,19,235,52,183
140,T140,151,Scott Langley,20,235,209,26
141,T142,149,Danny Lee,20,236,42,194
142,T142,142,Johnson Wagner,14,236,198,38
143,T144,T143,Branden Grace,18,237,68,169
144,T144,T110,Josh Teater,17,237,139,98
145,T146,T155,Si Woo Kim,20,238,104,134
146,T146,T129,Nate Lashley,13,238,176,62
147,T146,T158,Jimmy Walker,17,238,53,185
148,149,T147,Martin Trainer,19,239,32,207
149,T150,T136,J.J. Henry,15,240,168,72
150,T150,150,C.T. Pan,19,240,174,66
151,T152,T153,Martin Kaymer,11,242,128,114
152,T152,T123,Shawn Stefani,19,242,106,136
153,154,T155,Hudson Swafford,20,243,78,165
154,155,999,Shane Lowry,10,244,56,188
155,T156,172,Anders Albertson,18,245,122,123
156,T156,T155,Patrick Reed,15,245,84,161
157,T156,T158,Brandt Snedeker,18,245,159,86
158,159,T153,Richy Werenski,20,246,136,110
159,T160,T163,Pat Perez,16,247,179,68
160,T160,165,Cameron Tringale,15,247,87,160
161,162,T133,Dominic Bozzelli,17,248,109,139
162,163,180,Bill Haas,18,251,139,112
163,T164,T167,Ryan Blaum,21,252,155,97
164,T164,T167,John Chin,14,252,78,174
165,T164,T167,Charley Hoffman,18,252,90,162
166,167,170,Alex Cejka,16,253,203,50
167,T168,162,Roberto Castro,16,254,189,65
168,T168,166,Sam Saunders,18,254,74,180
169,T170,T158,Jim Knous,17,255,66,189
170,T170,171,Danny Willett,15,255,104,151
171,T172,T158,Joey Garber,15,257,136,121
172,T172,T173,Mackenzie Hughes,19,257,80,177
173,T172,T163,Seamus Power,21,257,91,166
174,175,T177,Adam Svensson,18,260,161,99
175,176,T173,Ben Crane,13,266,199,67
176,177,176,Peter Uihlein,22,267,64,203
177,178,175,Rod Pampling,16,268,178,90
178,179,T177,Stephan Jaeger,19,269,96,173
179,180,184,Nick Taylor,20,271,130,141
180,181,182,Tom Hoge,24,277,151,126
181,182,T185,Chris Kirk,17,278,184,94
182,183,188,Robert Streb,21,279,142,137
183,184,181,Scott Stallings,20,280,94,186
184,185,T189,John Huh,13,281,189,92
185,186,187,"Ted Potter, Jr.",18,282,201,81
186,T187,179,Kelly Kraft,23,283,150,133
187,T187,T189,John Senden,13,283,183,100
188,T189,T185,Stewart Cink,12,285,114,171
189,T189,192,Anirban Lahiri,17,285,139,146
190,191,183,Jordan Spieth,16,286,84,202
191,192,T189,José de Jesús Rodríguez,17,298,156,142
192,193,195,Cody Gribble,18,303,106,197
193,194,999,Tyrone Van Aswegen,11,306,142,164
194,195,193,Julián Etulain,17,309,114,195
195,196,198,Andrew Putnam,17,312,192,120
196,197,T199,Ernie Els,14,314,187,127
197,198,194,Whee Kim,21,316,186,130
198,199,T199,D.A. Points,13,319,208,111
199,200,201,Aaron Baddeley,15,321,158,163
200,201,197,Charl Schwartzel,13,323,118,205
201,202,196,Chris Stroud,19,325,151,174
202,203,203,Freddie Jacobson,14,328,185,143
203,204,202,Peter Malnati,19,330,132,198
204,205,204,Chris Thompson,12,335,134,201
205,206,205,Jonathan Byrd,13,338,193,145
206,207,206,Curtis Luck,17,345,164,181
207,208,999,Martin Piller,10,367,197,170
208,209,207,Michael Kim,21,395,202,193
